{
  "LevelsNb": 10,
  "Levels": [
    {
      "LevelNb": 1,
      "Dices": [
          [ 0, 4, 4, 4, 4, 4, 4, 4, 0 ],
          [ 0, 3, 3, 3, 3, 3, 3, 3, 0 ],
          [ 0, 0, 0, 0, 0, 0, 0, 0, 0 ],
          [ 0, 0, 0, 0, 0, 0, 0, 0, 0 ],
          [ 0, 0, 0, 0, 0, 0, 0, 0, 0 ],
          [ 0, 0, 0, 0, 0, 0, 0, 0, 0 ],
          [ 0, 0, 0, 0, 0, 0, 0, 0, 0 ],
          [ 0, 0, 0, 0, 0, 0, 0, 0, 0 ],
          [ 0, 0, 0, 0, 0, 0, 0, 0, 0 ]
        ]
    },
    {
      "LevelNb": 2,
      "Dices": [
          [ 0, 4, 0, 0, 0, 0, 0, 4, 0 ],
          [ 6, 0, 6, 0, 6, 0, 6, 0, 6 ],
          [ 3, 0, 3, 0, 3, 0, 3, 0, 3 ],
          [ 0, 0, 0, 0, 0, 0, 0, 0, 0 ],
          [ 0, 0, 0, 0, 0, 0, 0, 0, 0 ],
          [ 0, 0, 0, 0, 0, 0, 0, 0, 0 ],
          [ 0, 0, 0, 0, 0, 0, 0, 0, 0 ],
          [ 0, 0, 0, 0, 0, 0, 0, 0, 0 ],
          [ 0, 0, 0, 0, 0, 0, 0, 0, 0 ],
          [ 0, 0, 0, 0, 0, 0, 0, 0, 0 ],
          [ 0, 0, 0, 0, 0, 0, 0, 0, 0 ],
          [ 0, 0, 0, 0, 0, 0, 0, 0, 0 ]
      ]
    },
    {
      "LevelNb": 3,
      "Dices": [
        [ 0, 0, 0, 0, 0, 0, 0, 0, 0 ],
        [ 0, 8, 8, 8, 0, 8, 8, 8, 0 ],
        [ 0, 6, 6, 6, 0, 6, 6, 6, 0 ],
        [ 0, 0, 0, 0, 0, 0, 0, 0, 0 ],
        [ 0, 0, 4, 0, 0, 0, 3, 0, 0 ],
        [ 0, 0, 0, 0, 0, 0, 0, 0, 0 ],
        [ 0, 0, 0, 0, 0, 0, 0, 0, 0 ],
        [ 0, 0, 0, 0, 0, 0, 0, 0, 0 ],
        [ 0, 0, 0, 0, 0, 0, 0, 0, 0 ],
        [ 0, 0, 0, 0, 0, 0, 0, 0, 0 ],
        [ 0, 0, 0, 0, 0, 0, 0, 0, 0 ],
        [ 0, 0, 0, 0, 0, 0, 0, 0, 0 ]
      ]
    },
    {
      "LevelNb": 4,
      "Dices": [
        [ 0, 0, 0, 0, 0, 0, 0, 0, 0 ],
        [ 0, 0, 0, 0, 0, 0, 0, 0, 0 ],
        [ 10, 0, 0, 0, 6, 0, 0, 0, 10 ],
        [ 0, 0, 0, 0, 0, 0, 0, 0, 0 ],
        [ 10, 0, 0, 0, 4, 0, 0, 0, 10 ],
        [ 0, 0, 4, 4, 4, 4, 4, 0, 0 ],
        [ 0, 0, 0, 0, 0, 0, 0, 0, 0 ],
        [ 0, 0, 0, 0, 0, 0, 0, 0, 0 ],
        [ 0, 0, 0, 0, 0, 0, 0, 0, 0 ],
        [ 0, 0, 0, 0, 0, 0, 0, 0, 0 ],
        [ 0, 0, 0, 0, 0, 0, 0, 0, 0 ],
        [ 0, 0, 0, 0, 0, 0, 0, 0, 0 ]
      ]
    },
    {
      "LevelNb": 5,
      "Dices": [
        [ 0, 0, 0, 0, 0, 0, 0, 0, 0 ],
        [ 0, 4, 6, 4, 6, 4, 6, 4, 0 ],
        [ 0, 0, 0, 0, 0, 0, 0, 0, 0 ],
        [ 0, 10, 0, 0, 12, 0, 0, 10, 0 ],
        [ 0, 10, 0, 0, 0, 0, 0, 10, 0 ],
        [ 0, 0, 0, 12, 0, 12, 0, 0, 0 ],
        [ 0, 0, 0, 0, 0, 0, 0, 0, 0 ],
        [ 0, 0, 0, 0, 0, 0, 0, 0, 0 ],
        [ 0, 0, 0, 0, 0, 0, 0, 0, 0 ],
        [ 0, 0, 0, 0, 0, 0, 0, 0, 0 ],
        [ 0, 0, 0, 0, 0, 0, 0, 0, 0 ],
        [ 0, 0, 0, 0, 0, 0, 0, 0, 0 ]
      ]
    },
    {
      "LevelNb": 6,
      "Dices": [
        [ 0, 0, 0, 0, 0, 0, 0, 0, 0 ],
        [ 0, 12, 0, 0, 10, 0, 12, 0, 0 ],
        [ 0, 8, 0, 10, 0, 0, 8, 0, 0 ],
        [ 0, 8, 0, 0, 10, 0, 8, 0, 0 ],
        [ 0, 12, 0, 10, 0, 0, 12, 0, 0 ],
        [ 0, 0, 4, 0, 0, 4, 0, 0, 0 ],
        [ 0, 0, 0, 0, 0, 0, 0, 0, 0 ],
        [ 0, 0, 0, 0, 0, 0, 0, 0, 0 ],
        [ 0, 0, 0, 0, 0, 0, 0, 0, 0 ],
        [ 0, 0, 0, 0, 0, 0, 0, 0, 0 ],
        [ 0, 0, 0, 0, 0, 0, 0, 0, 0 ],
        [ 0, 0, 0, 0, 0, 0, 0, 0, 0 ]
      ]
    },
    {
      "LevelNb": 7,
      "Dices": [
        [ 0, 0, 0, 6, 20, 6, 0, 0, 0 ],
        [ 0, 12, 0, 0, 0, 0, 0, 12, 0 ],
        [ 0, 0, 12, 10, 10, 10, 12, 0, 0 ],
        [ 0, 0, 0, 0, 0, 0, 0, 0, 0 ],
        [ 0, 8, 0, 0, 0, 0, 0, 8, 0 ],
        [ 0, 0, 4, 4, 0, 4, 4, 0, 0 ],
        [ 0, 0, 0, 0, 0, 0, 0, 0, 0 ],
        [ 0, 0, 0, 0, 0, 0, 0, 0, 0 ],
        [ 0, 0, 0, 0, 0, 0, 0, 0, 0 ],
        [ 0, 0, 0, 0, 0, 0, 0, 0, 0 ],
        [ 0, 0, 0, 0, 0, 0, 0, 0, 0 ],
        [ 0, 0, 0, 0, 0, 0, 0, 0, 0 ]
      ]
    },
    {
      "LevelNb": 8,
      "Dices": [
        [ 20, 0, 0, 0, 0, 0, 0, 0, 20 ],
        [ 0, 0, 0, 12, 0, 12, 0, 0, 0 ],
        [ 0, 0, 0, 12, 12, 12, 0, 0, 0 ],
        [ 0, 10, 10, 0, 0, 0, 10, 10, 0 ],
        [ 0, 10, 10, 0, 0, 0, 10, 10, 0 ],
        [ 0, 0, 0, 0, 0, 0, 0, 0, 0 ],
        [ 0, 0, 0, 0, 0, 0, 0, 0, 0 ],
        [ 0, 0, 0, 0, 0, 0, 0, 0, 0 ],
        [ 0, 0, 0, 0, 0, 0, 0, 0, 0 ],
        [ 0, 0, 0, 0, 0, 0, 0, 0, 0 ],
        [ 0, 0, 0, 0, 0, 0, 0, 0, 0 ],
        [ 0, 0, 0, 0, 0, 0, 0, 0, 0 ]
      ]
    },
    {
      "LevelNb": 9,
      "Dices": [
        [ 0, 0, 20, 20, 20, 20, 20, 0, 0 ],
        [ 10, 0, 0, 0, 0, 0, 0, 0, 10 ],
        [ 0, 0, 20, 20, 20, 20, 20, 0, 0 ],
        [ 0, 0, 0, 0, 0, 0, 0, 0, 0 ],
        [ 0, 0, 0, 4, 4, 4, 0, 0, 0 ],
        [ 0, 0, 0, 0, 0, 0, 0, 0, 0 ],
        [ 0, 0, 0, 0, 0, 0, 0, 0, 0 ],
        [ 0, 0, 0, 0, 0, 0, 0, 0, 0 ],
        [ 0, 0, 0, 0, 0, 0, 0, 0, 0 ],
        [ 0, 0, 0, 0, 0, 0, 0, 0, 0 ],
        [ 0, 0, 0, 0, 0, 0, 0, 0, 0 ],
        [ 0, 0, 0, 0, 0, 0, 0, 0, 0 ]
      ]
    },
    {
      "LevelNb": 10,
      "Dices": [
          [ 0, 0, 0, 3, 3, 3, 0, 0, 0 ],
          [ 0, 0, 4, 0, 10, 0, 4, 0, 0 ],
          [ 0, 6, 0, 0, 20, 0, 0, 6, 0 ],
          [ 0, 8, 10, 20, 20, 20, 10, 8, 0 ],
          [ 0, 6, 0, 0, 20, 0, 0, 6, 0 ],
          [ 0, 0, 4, 0, 10, 0, 4, 0, 0 ],
          [ 0, 0, 0, 3, 0, 3, 0, 0, 0 ],
          [ 0, 0, 0, 0, 0, 0, 0, 0, 0 ],
          [ 0, 0, 0, 0, 0, 0, 0, 0, 0 ],
          [ 0, 0, 0, 0, 0, 0, 0, 0, 0 ],
          [ 0, 0, 0, 0, 0, 0, 0, 0, 0 ],
          [ 0, 0, 0, 0, 0, 0, 0, 0, 0 ]
        ]
    }
  ]

}
