{
  "levels": [
    {
      "level": 1,
      "dices": [
        [ 0, 0, 0, 0, 0, 0 ],
        [ 0, 3, 3, 3, 3, 0 ],
        [ 0, 0, 3, 0, 0, 0 ],
        [ 0, 0, 3, 0, 0, 0 ],
        [ 0, 0, 3, 3, 3, 0 ],
        [ 0, 0, 0, 0, 0, 3 ]
      ]
    },
    {
      "level": 2,
      "dices": [
        [ 0, 0, 0, 0, 0, 0 ],
        [ 0, 3, 3, 3, 0, 0 ],
        [ 0, 4, 0, 4, 4, 4 ],
        [ 0, 0, 0, 3, 4, 0 ],
        [ 0, 0, 0, 0, 3, 0 ],
        [ 0, 0, 0, 0, 0, 0 ]
      ]
    },
    {
      "level": 3,
      "dices": [
        [ 0, 0, 4, 3, 3, 0 ],
        [ 0, 3, 4, 0, 0, 0 ],
        [ 3, 0, 3, 3, 3, 0 ],
        [ 3, 0, 4, 0, 3, 0 ],
        [ 0, 4, 4, 0, 3, 0 ],
        [ 0, 0, 0, 0, 0, 3 ]
      ]
    },
    {
      "level": 4,
      "dices": [
        [ 0, 0, 4, 4, 0, 0 ],
        [ 0, 4, 4, 4, 4, 0 ],
        [ 0, 4, 4, 3, 3, 0 ],
        [ 0, 0, 6, 6, 6, 0 ],
        [ 0, 0, 0, 0, 0, 0 ],
        [ 0, 6, 0, 6, 0, 6 ]
      ]
    }
  ]
  
}
